11111111111111
10C00000011C01
10000010010CC1
1001G000110011
10000100000101
10000001110011
10000001100G01
100000001C1001
1001PG01C10001
11E10000001101
101C0110011101
11000000110101
11111111111111